NO ./assets/NORTH.xpm
SO ./assets/SOUTH.xpm
WE ./assets/WEST.xpm
EA ./assets/EAST.xpm
F 220,100,0
C 250,30,0

1111111111111111111111111
1000000000110000000000001
101100001100000000000001
100100000000000000000000111111111
111111111011000001110000000000001
100000000011000001110111111311111
11110111111111011100000010001
11110111111111011101010010001
11000000110101011100000010001
10000000000000001100000020001
10000000000000001101010010001
11000001110101011111011110S0111
11110111 1110101 101111010001
11111111 1111111 111111111111
