NO ./assets/NORTH.xpm
SO ./assets/SOUTH.xpm
WE ./assets/WEST.xpm
EA ./assets/EAST.xpm
F 220,100,0
C 250,30,0

     11111
     10S01
     10001
     10001
111111131111111
100000000000001
100000000000001
100000000000001
100000000000001
100000000000001
100000000000001
100000000000001
100000000000001
100000000000001
100000000000001
111111131111111
