NO ./assets/NORTH.xpm
SO ./assets/SOUTH.xpm
WE ./assets/WEST.xpm
EA ./assets/EAST.xpm

F 49,31,31
C 26,26,26

1     11111                    
11111100000111111          1111111111
10000000000000001          1000000001
1000000000000000111111111111007070701
1000000000000000040000000001000000001
1000000000000000030000000002000000001
1000000000000000050000000001000000001
1000000000000000111100001111000000001
1000000000000000111110011  1007777001
11111100000111111   1001   1000000001
     1113111        1001   1110110111
      10001         1001     161161
      10001         1001
      10001         100118181818111
      10001         100111010101011
      10001         100010000000001
      10001         100000000000001
      10001         100010000000001
      10001         111111010101011
      10001              171717171
      10001
      10001
 111111131111111
 100001000100001
 100000000300001
 100001000100001
 111111000111111
 100001000100001
 1E0003000300001
 100001000100001
 111111000111111
 100000000000001
 100000000000001
 100000000000001
 111111111111111

