NO ./assets/NORTH.xpm
SO ./assets/SOUTH.xpm
WE ./assets/WEST.xpm
EA ./assets/EAST.xpm

F 49,31,31
C 26,26,26

      11111                    
11111100007111111          1111111111
11110000000000771          1000000001
1110070000070000111111111111007070701
1100000000000000020000000001000000001
1000000000000000030000000003000000001
1100000000000000020000000001000000001
1110070000070000111100001111000000001
1111000000000701111110011  1007777001
11111100000117011   10007  1000000001
     1113111 181    10007  1110110111
      10001        60001     161161
      80008        60001
      10001         100111818181811
      80008         100111010101011
      10001         100010000000001
      80008         100000000000001
      10001         100010000000001
      80008         111111010101011
      10001    54545     171717525
      80008    50004           404
      10001    4540545454545454505
 111111131111111 50000000000000004
 100001000100001540545454545454545
 1000030003007023004
 1000010001000015454
 111111000111111
 100001000100001
 1E0003000300001
 100001000100001
 111111000111111
 100000000000001
 100000000000001
 100000000000001
 111111111111111

