NO ./assets/NORTH.xpm
SO ./assets/SOUTH.xpm
WE ./assets/WEST.xpm
EA ./assets/EAST.xpm
F 49,31,31
C 26,26,26

     11111
     10S01
     10001
     10001
111111121111111
100000000000001
100000000000001
100000000000001
100000000000001
100000000000001
100000000000003
100000000000001
100000000000001
100000000000001
100000000000001
111111111111111
